22,23,23,23,23,23,23,24,21,25,26,26,26,26,26,27
32,01,01,01,01,01,01,01,01,01,01,01,01,01,01,37
32,01,01,01,01,01,01,01,01,01,01,01,01,01,01,37
32,01,01,01,01,01,01,01,01,01,20,20,20,01,01,37
32,01,01,01,01,01,01,01,01,01,01,01,01,01,01,37
32,01,01,01,01,01,01,01,01,01,01,01,01,01,01,37
42,01,01,01,01,01,01,01,01,01,01,01,01,01,01,47
42,01,01,01,01,01,01,01,01,01,01,01,01,01,01,47
42,01,01,01,01,01,01,01,01,01,01,01,01,01,01,47
42,01,20,01,01,01,01,01,01,01,01,01,01,20,01,47
42,01,01,01,01,01,01,01,01,01,01,01,01,01,01,47
52,53,53,53,53,53,56,54,10,55,56,56,56,56,56,57
22,23,23,23,23,23,23,24,10,25,26,26,26,26,26,27
32,01,01,01,01,01,01,01,01,01,01,01,01,01,01,37
32,01,01,01,01,01,01,01,01,01,01,01,01,01,01,37
32,01,01,01,01,01,01,01,01,01,01,01,01,01,01,37
32,01,01,01,01,01,01,01,01,01,01,01,01,01,01,37
32,01,01,01,01,01,01,01,01,01,01,01,01,01,01,37
42,01,20,01,01,01,01,01,01,01,01,01,01,20,01,47
42,01,20,01,01,01,01,01,01,01,01,01,01,20,01,47
42,01,20,01,01,01,01,01,01,01,01,01,01,20,01,47
42,01,20,01,01,01,01,01,01,01,01,01,01,20,01,47
42,01,01,01,01,01,01,01,01,01,01,01,01,01,01,47
52,53,53,53,53,53,56,56,56,56,56,56,56,56,56,57



